12 24
########################
#.........#......#.....#
##.....O###............#
###.............O#.....#
####.............#O....#
##################.....#
####.............#.....#
###...............O..###
##...........#########o#
#....................oo#
#S....................o#
########################